2 2 2 2 2 2 2 2 2 2 2 2 2 2 2 2 2 2 2 2 2 2 2 2 2 2 2 2 2 2 
2 2 2 2 2 2 2 2 2 2 2 2 2 2 2 2 2 2 2 2 2 2 2 2 2 2 2 2 2 2 
2 2 2 2 2 2 2 2 2 2 2 2 2 2 2 2 2 2 2 2 2 2 2 2 2 2 2 2 2 2 
2 2 2 2 2 2 2 2 2 3 3 3 3 3 3 3 3 3 2 2 2 2 2 2 2 2 2 2 2 2 
2 2 2 2 2 2 2 3 3 3 3 0 0 3 3 3 3 3 3 3 2 2 2 2 2 2 2 2 2 2 
2 2 2 2 2 2 4 4 3 3 0 0 0 0 0 0 0 3 3 3 3 3 3 2 2 2 2 2 2 2 
2 2 2 2 2 2 3 4 4 0 0 0 0 0 0 0 0 0 0 0 3 3 3 3 3 3 2 2 2 2 
2 2 2 2 2 2 3 3 4 4 0 0 0 4 4 4 4 0 0 0 0 0 0 3 3 3 3 2 2 2 
2 2 2 2 2 3 3 0 0 4 4 4 4 4 0 0 4 4 4 0 0 0 0 0 0 3 3 2 2 2 
2 2 2 2 2 3 3 0 0 0 4 4 0 0 0 0 0 0 4 4 4 0 0 0 0 3 3 2 2 2 
2 2 2 2 3 3 3 0 0 0 0 4 4 0 0 0 0 0 0 0 4 4 0 0 0 3 3 2 2 2 
2 2 2 2 3 3 0 0 0 0 0 0 4 0 5 5 5 0 0 0 0 4 0 0 0 3 3 2 2 2 
2 2 2 2 3 3 0 0 0 0 0 0 4 5 5 5 5 5 0 0 0 4 0 0 0 3 3 2 2 2 
2 2 2 2 3 3 0 0 0 0 0 0 4 6 5 5 5 5 0 0 0 4 0 0 0 3 2 2 2 2 
2 2 2 2 3 3 0 0 0 0 6 6 4 4 6 5 5 5 0 0 4 4 0 0 3 3 2 2 2 2 
2 2 2 2 3 3 0 0 0 6 6 6 6 4 0 6 5 0 0 0 4 0 0 0 3 3 2 2 2 2 
2 2 2 2 3 3 0 0 0 6 6 6 6 4 4 0 0 0 0 0 4 0 0 0 3 3 2 2 2 2 
2 2 2 2 3 3 0 0 0 6 6 6 6 6 4 4 4 0 0 0 4 0 0 0 3 3 2 2 2 2 
2 2 2 2 3 3 0 0 0 0 6 6 6 6 6 0 4 4 0 4 4 0 0 0 3 3 2 2 2 2 
2 2 2 2 3 3 0 0 0 0 6 6 6 6 6 0 0 4 4 4 0 0 0 0 3 3 2 2 2 2 
2 2 2 2 3 3 0 0 0 0 0 6 6 6 0 0 0 0 4 4 0 0 0 0 3 3 2 2 2 2 
2 2 2 2 3 3 0 0 0 0 0 0 0 0 0 0 0 0 0 4 4 0 0 0 3 3 2 2 2 2 
2 2 2 2 2 3 3 0 0 0 0 0 0 0 0 0 0 0 0 0 4 4 0 0 3 3 2 2 2 2 
2 2 2 2 2 3 3 0 0 0 0 0 0 0 0 0 0 0 0 0 0 4 0 0 3 3 2 2 2 2 
2 2 2 2 2 2 3 3 3 0 0 0 0 0 0 0 0 0 0 0 0 4 4 0 3 3 2 2 2 2 
2 2 2 2 2 2 2 3 3 3 3 3 3 3 3 3 3 3 3 0 0 0 4 4 3 2 2 2 2 2 
2 2 2 2 2 2 2 2 2 2 2 2 3 3 3 3 3 3 3 3 0 0 0 4 4 2 2 2 2 2 
2 2 2 2 2 2 2 2 2 2 2 2 2 2 2 2 2 2 2 3 3 3 3 3 2 2 2 2 2 2 
2 2 2 2 2 2 2 2 2 2 2 2 2 2 2 2 2 2 2 2 2 2 2 2 2 2 2 2 2 2 
2 2 2 2 2 2 2 2 2 2 2 2 2 2 2 2 2 2 2 2 2 2 2 2 2 2 2 2 2 2 
