30x30
2

MAP START
2 2 2 2 2 2 2 2 2 2 2 2 2 2 2 2 2 2 2 2 2 2 2 2 2 2 2 2 2 2 
2 2 2 2 2 2 2 2 2 2 2 2 2 2 2 2 2 2 2 2 2 2 2 2 2 2 2 2 2 2 
2 2 2 2 2 2 2 2 2 2 2 2 2 2 2 2 2 2 2 2 2 2 2 2 2 2 2 2 2 2 
2 2 2 2 2 2 2 2 2 2 3 3 3 3 2 2 2 2 2 2 2 2 2 2 2 2 2 2 2 2 
2 2 2 2 2 2 2 2 2 3 3 0 0 3 3 3 3 3 2 2 2 2 2 2 2 2 2 2 2 2 
2 2 2 2 2 2 2 3 3 3 0 0 0 0 0 0 0 3 3 3 3 2 2 2 2 2 2 2 2 2 
2 2 2 2 2 2 2 3 4 0 0 0 0 0 0 0 0 0 0 0 3 3 2 2 2 2 2 2 2 2 
2 2 2 2 2 2 3 3 4 4 0 0 0 4 4 4 4 0 0 0 0 3 2 2 2 2 2 2 2 2 
2 2 2 2 2 2 3 0 0 4 4 4 4 4 0 6 4 4 4 0 0 3 3 2 2 2 2 2 2 2 
2 2 2 2 2 2 3 0 0 0 4 4 0 0 0 0 6 6 4 4 0 0 3 2 2 2 2 2 2 2 
2 2 2 2 2 3 3 0 0 0 0 4 4 0 0 0 6 6 6 4 0 0 3 3 2 2 2 2 2 2 
2 2 2 2 2 3 0 0 2 0 0 0 4 0 5 5 5 6 6 4 0 0 0 3 2 2 2 2 2 2 
2 2 2 2 2 3 2 2 2 0 0 0 4 5 5 5 5 5 6 4 4 0 0 3 3 2 2 2 2 2 
2 2 2 2 2 2 2 0 0 0 0 0 4 6 5 5 5 5 6 6 4 6 0 0 3 2 2 2 2 2 
2 2 2 2 2 3 3 0 0 0 6 6 4 4 6 5 5 5 0 0 4 6 0 0 3 2 2 2 2 2 
2 2 2 2 2 3 0 0 0 6 6 6 6 4 0 6 5 0 0 0 4 6 0 0 3 2 2 2 2 2 
2 2 2 2 2 3 0 0 0 6 6 6 4 4 4 0 0 0 0 0 4 6 0 0 3 2 2 2 2 2 
2 2 2 2 2 3 0 0 0 5 5 4 4 6 4 4 4 0 0 0 4 6 0 0 3 2 2 2 2 2 
2 2 2 2 2 3 0 0 0 5 4 4 5 6 6 0 4 4 0 4 4 0 0 0 3 2 2 2 2 2 
2 2 2 2 2 3 0 0 0 0 4 5 6 6 6 0 0 4 4 4 0 0 0 0 3 2 2 2 2 2 
2 2 2 2 2 3 0 0 0 4 4 5 6 6 0 0 0 0 4 4 0 0 0 0 3 2 2 2 2 2 
2 2 2 2 2 3 0 0 4 4 0 0 0 0 0 0 2 0 0 4 4 0 0 0 3 2 2 2 2 2 
2 2 2 2 2 3 3 0 0 0 0 0 0 0 0 2 2 0 0 0 4 4 0 0 3 2 2 2 2 2 
2 2 2 2 2 2 3 0 0 0 0 0 0 0 0 2 0 0 0 0 0 4 0 0 3 2 2 2 2 2 
2 2 2 2 2 2 3 3 3 0 0 0 3 3 2 2 0 0 0 0 0 4 4 0 3 2 2 2 2 2 
2 2 2 2 2 2 2 2 3 3 3 3 3 2 2 3 3 3 3 0 0 0 4 4 3 2 2 2 2 2 
2 2 2 2 2 2 2 2 2 2 2 2 2 2 2 2 2 2 3 3 0 0 0 3 3 2 2 2 2 2 
2 2 2 2 2 2 2 2 2 2 2 2 2 2 2 2 2 2 2 3 3 3 3 3 2 2 2 2 2 2 
2 2 2 2 2 2 2 2 2 2 2 2 2 2 2 2 2 2 2 2 2 2 2 2 2 2 2 2 2 2 
2 2 2 2 2 2 2 2 2 2 2 2 2 2 2 2 2 2 2 2 2 2 2 2 2 2 2 2 2 2 
MAP END

UNITS START
Jeep 0 19 20 90
Jeep 0 20 22 180
Tank 0 18 22 90
Tank 0 21 20 180
Artillery 0 21 19 180
AntiArmour 0 18 21 90
Battleship 0 27 20 90
Battleship 0 13 27 180
Jeep 1 11 9 270
Jeep 1 9 8 0
Tank 1 10 7 270
Tank 1 12 7 270
Artillery 1 9 10 0
AntiArmour 1 10 9 270
Battleship 1 2 10 270
Battleship 1 18 1 0
UNITS END
